11111111111111111111111111111
11010001101011000110111000111
10000010000010010001000010001
10000000010000000000000100101
10100000111100000000001010001
10001001011001010010110010011
10000010000010101000001111011
10100001000000000011001101101
10000001001000110010010000011
10100000110000000100011110001
1000100110000001E010100100101
10000010010010000101110101001
10100010000111000000010110111
10000101000001100001001000011
11001000101100000011000000111
11010000000010000101000010101
11000001000000010000110110101
1110001000111000001C000010011
100110000000P1000000001100101
11000001000011010001001010001
10010000010010000000000000111
11011010000100110010000000011
11010000100000010100000010001
10010111000000011000100100001
10010011110000001000001010011
10001010110100000000010100001
10001000001011000100010110101
11000001001000101000000001001
10000000010110000011000000011
10111100001000000001101000111
10111000111000101100000000001
10000001101010001010001110011
10100000011001010000100000011
11111111111111111111111111111
