111111111111111111
1100C01E1000011101
111110101101CP0101
11010000100C010001
101011101011111101
110010100001001101
111111111111111111
