11111111111
10001000011
10000000011
10000010011
11C01100001
10011011011
11100000001
10110100101
1C001000001
100E0100C11
10000100011
1000000C101
11001001011
10101000111
1P001001101
11000111011
11111111111
