1111111
1000011
1001011
1C1E001
10011X1
110P1L1
1101101
1111111
