11111111111111111
11011010000100011
10011010000011101
10001011100000101
11101001000100011
10000110000010001
10000000000001001
100000001P1E00001
10110010000100011
10100011000010001
1C000000001000101
11001001001000001
10001110000011011
10001000000001001
11111111111111111
