11111111111111111111
11001C0000C001110001
1100010100P010011001
11000000000001000111
10000001001000001001
10100010001E11010101
10011100111001000011
11111111111111111111
