1111111111111111
100111E001000001
1000000000100001
1000001001100011
1010000110000001
101000000011C001
1000010110000011
1101100000000011
1001000000101001
1100011000010011
1100000001010001
10001000110C0001
1110000001000001
1001111000000001
1110000010000011
10000000P0100C01
1000100110100001
1111111111111111
