111111111111111111
1100111C0001000011
100111010010011001
1011111010C0101101
1E0100P10100001001
110011000000110111
110C000110C0001111
1000C0111001110011
100010011110111001
100111111010101001
111111111111111111
