11111111111111
1C000000000001
10000000000001
10100000111101
10100000000101
10101000000101
101P1000111101
10111100100001
10001000100001
10001000111101
100000000000E1
11111111111111
